1111111111111111111111111111111111
10000001C00000000C0000000011000001
10P00000001111000000000000C0000001
1000000000000000000000000000000001
10000C0000000C00000111111000000001
1000001111000C00000000000000000001
1000001111000000000000000000000001
1000000000000011111111000000000001
100000000C000000000000000000000001
100000000001111110000C000000000001
1000000000000111111110000000000001
1000000000000000000000000000000001
1000000000000000C00C00000000000001
1000000000011111111111000000000001
1000000000000000000000000000000001
10000000000001111000000000000C0001
1111111111111000000000000000000001
1000000C00000000001111000000000E01
10000000000C0000011111000000000001
1111111111111111111111111111111111