1111111111111111111111111111111111
1EP00001C00000000C0000000011100001
10000000001111000000000000C0100001
1000000000000000000000000000100001
10000C0000000C00000111111000100001
1000001111000C00000000000000100001
1000001111000000000000000000100001
1000000000000011111111000000000001
100000000C000000000000000000100001
100000000001111110000C000000100001
1000000000000111111110000000100001
1000000000000000000000000000100001
1000000000000000C00C00000000110001
10000000000111111111110000001C1001
1000C00000000000000000000000100001
1000000000000111100000000000100001
1111111111111000000000000000100001
1000000C00000000001111000000100001
10000000000C0000011111000000100001
1111111111111111111111111111111111