111111111111
1P00000C0011
1000000E0011
1000000C0011
111111111111